"filename", "language", "PowerShell", "Lua", "C++", "Makefile", "comment", "blank", "total"
"c:\Users\Silve\Develop\CSOL-24H\source\Commander.ps1", "PowerShell", 23, 0, 0, 0, 0, 3, 26
"c:\Users\Silve\Develop\CSOL-24H\source\Controller\DateTime.cpp", "C++", 0, 0, 51, 0, 0, 2, 53
"c:\Users\Silve\Develop\CSOL-24H\source\Controller\LogTracker.cpp", "C++", 0, 0, 146, 0, 28, 15, 189
"c:\Users\Silve\Develop\CSOL-24H\source\Controller\Makefile", "Makefile", 0, 0, 0, 8, 0, 1, 9
"c:\Users\Silve\Develop\CSOL-24H\source\Controller\command.cpp", "C++", 0, 0, 30, 0, 3, 2, 35
"c:\Users\Silve\Develop\CSOL-24H\source\Controller\csol24except.cpp", "C++", 0, 0, 18, 0, 0, 3, 21
"c:\Users\Silve\Develop\CSOL-24H\source\Controller\execution.cpp", "C++", 0, 0, 105, 0, 12, 10, 127
"c:\Users\Silve\Develop\CSOL-24H\source\Controller\game.cpp", "C++", 0, 0, 227, 0, 24, 14, 265
"c:\Users\Silve\Develop\CSOL-24H\source\Controller\global.cpp", "C++", 0, 0, 17, 0, 0, 6, 23
"c:\Users\Silve\Develop\CSOL-24H\source\Controller\hotkey.cpp", "C++", 0, 0, 30, 0, 0, 8, 38
"c:\Users\Silve\Develop\CSOL-24H\source\Controller\main.cpp", "C++", 0, 0, 0, 0, 0, 1, 1
"c:\Users\Silve\Develop\CSOL-24H\source\Controller\util.cpp", "C++", 0, 0, 49, 0, 0, 2, 51
"c:\Users\Silve\Develop\CSOL-24H\source\RoundTimer.ps1", "PowerShell", 0, 0, 0, 0, 1, 2, 3
"c:\Users\Silve\Develop\CSOL-24H\source\include\DateTime.hpp", "C++", 0, 0, 6, 0, 0, 1, 7
"c:\Users\Silve\Develop\CSOL-24H\source\include\command.hpp", "C++", 0, 0, 14, 0, 0, 5, 19
"c:\Users\Silve\Develop\CSOL-24H\source\include\const.hpp", "C++", 0, 0, 10, 0, 0, 0, 10
"c:\Users\Silve\Develop\CSOL-24H\source\include\csol24except.hpp", "C++", 0, 0, 43, 0, 0, 5, 48
"c:\Users\Silve\Develop\CSOL-24H\source\include\game.hpp", "C++", 0, 0, 36, 0, 1, 4, 41
"c:\Users\Silve\Develop\CSOL-24H\source\include\global.hpp", "C++", 0, 0, 22, 0, 0, 8, 30
"c:\Users\Silve\Develop\CSOL-24H\source\include\util.hpp", "C++", 0, 0, 14, 0, 0, 2, 16
"c:\Users\Silve\Develop\CSOL-24H\source\logi\Craft.lua", "Lua", 0, 27, 0, 0, 0, 2, 29
"c:\Users\Silve\Develop\CSOL-24H\source\logi\Dispacher.lua", "Lua", 0, 22, 0, 0, 0, 1, 23
"c:\Users\Silve\Develop\CSOL-24H\source\logi\Player.lua", "Lua", 0, 204, 0, 0, 87, 25, 316
"c:\Users\Silve\Develop\CSOL-24H\source\logi\Round.lua", "Lua", 0, 234, 0, 0, 34, 11, 279
"c:\Users\Silve\Develop\CSOL-24H\source\logi\Store.lua", "Lua", 0, 22, 0, 0, 0, 2, 24
"c:\Users\Silve\Develop\CSOL-24H\source\logi\Utility.lua", "Lua", 0, 25, 0, 0, 10, 4, 39
"c:\Users\Silve\Develop\CSOL-24H\source\logi\Weapon.lua", "Lua", 0, 56, 0, 0, 21, 6, 83
"c:\Users\Silve\Develop\CSOL-24H\source\logi\main.lua", "Lua", 0, 31, 0, 0, 0, 4, 35
"c:\Users\Silve\Develop\CSOL-24H\source\lua\$~cmd.lua", "Lua", 0, 1, 0, 0, 0, 0, 1
"c:\Users\Silve\Develop\CSOL-24H\source\lua\Command.lua", "Lua", 0, 12, 0, 0, 0, 0, 12
"c:\Users\Silve\Develop\CSOL-24H\source\lua\Console.lua", "Lua", 0, 20, 0, 0, 14, 6, 40
"c:\Users\Silve\Develop\CSOL-24H\source\lua\Context.lua", "Lua", 0, 17, 0, 0, 6, 3, 26
"c:\Users\Silve\Develop\CSOL-24H\source\lua\DateTime.lua", "Lua", 0, 61, 0, 0, 15, 5, 81
"c:\Users\Silve\Develop\CSOL-24H\source\lua\Delay.lua", "Lua", 0, 14, 0, 0, 0, 0, 14
"c:\Users\Silve\Develop\CSOL-24H\source\lua\Executor.lua", "Lua", 0, 50, 0, 0, 6, 6, 62
"c:\Users\Silve\Develop\CSOL-24H\source\lua\Global.lua", "Lua", 0, 23, 0, 0, 1, 0, 24
"c:\Users\Silve\Develop\CSOL-24H\source\lua\Interpreter.lua", "Lua", 0, 30, 0, 0, 1, 1, 32
"c:\Users\Silve\Develop\CSOL-24H\source\lua\Keyboard.lua", "Lua", 0, 130, 0, 0, 34, 14, 178
"c:\Users\Silve\Develop\CSOL-24H\source\lua\Mouse.lua", "Lua", 0, 123, 0, 0, 56, 14, 193
"c:\Users\Silve\Develop\CSOL-24H\source\lua\Runtime.lua", "Lua", 0, 98, 0, 0, 30, 9, 137
"c:\Users\Silve\Develop\CSOL-24H\source\lua\Setting.lua", "Lua", 0, 31, 0, 0, 14, 1, 46
"c:\Users\Silve\Develop\CSOL-24H\source\lua\entrypoint.lua", "Lua", 0, 1, 0, 0, 0, 1, 2
"c:\Users\Silve\Develop\CSOL-24H\source\lua\main.lua", "Lua", 0, 9, 0, 0, 3, 0, 12
"Total", "-", 23, 1241, 818, 8, 401, 209, 2700