"filename", "language", "Lua", "PowerShell", "Makefile", "C++", "comment", "blank", "total"
"c:\Users\Silve\Develop\CSOL-24H\source\Commander.ps1", "PowerShell", 0, 23, 0, 0, 0, 3, 26
"c:\Users\Silve\Develop\CSOL-24H\source\Controller\CSOL24H.cpp", "C++", 0, 0, 0, 309, 24, 18, 351
"c:\Users\Silve\Develop\CSOL-24H\source\Controller\CSOL24H_EXCEPT.cpp", "C++", 0, 0, 0, 18, 0, 3, 21
"c:\Users\Silve\Develop\CSOL-24H\source\Controller\Command.cpp", "C++", 0, 0, 0, 30, 0, 2, 32
"c:\Users\Silve\Develop\CSOL-24H\source\Controller\Console.cpp", "C++", 0, 0, 0, 53, 0, 5, 58
"c:\Users\Silve\Develop\CSOL-24H\source\Controller\DateTime.cpp", "C++", 0, 0, 0, 101, 25, 4, 130
"c:\Users\Silve\Develop\CSOL-24H\source\Controller\GameProcess.cpp", "C++", 0, 0, 0, 169, 11, 2, 182
"c:\Users\Silve\Develop\CSOL-24H\source\Controller\GameState.cpp", "C++", 0, 0, 0, 228, 10, 5, 243
"c:\Users\Silve\Develop\CSOL-24H\source\Controller\HotKey.cpp", "C++", 0, 0, 0, 88, 0, 1, 89
"c:\Users\Silve\Develop\CSOL-24H\source\Controller\Makefile", "Makefile", 0, 0, 8, 0, 0, 1, 9
"c:\Users\Silve\Develop\CSOL-24H\source\Controller\Util.cpp", "C++", 0, 0, 0, 49, 0, 3, 52
"c:\Users\Silve\Develop\CSOL-24H\source\Controller\main.cpp", "C++", 0, 0, 0, 33, 1, 1, 35
"c:\Users\Silve\Develop\CSOL-24H\source\RoundTimer.ps1", "PowerShell", 0, 0, 0, 0, 1, 2, 3
"c:\Users\Silve\Develop\CSOL-24H\source\include\CSOL24H.hpp", "C++", 0, 0, 0, 82, 8, 2, 92
"c:\Users\Silve\Develop\CSOL-24H\source\include\CSOL24H_EXCEPT.hpp", "C++", 0, 0, 0, 43, 0, 5, 48
"c:\Users\Silve\Develop\CSOL-24H\source\include\Command.hpp", "C++", 0, 0, 0, 14, 0, 1, 15
"c:\Users\Silve\Develop\CSOL-24H\source\include\Console.hpp", "C++", 0, 0, 0, 16, 0, 2, 18
"c:\Users\Silve\Develop\CSOL-24H\source\include\GameState.hpp", "C++", 0, 0, 0, 54, 6, 3, 63
"c:\Users\Silve\Develop\CSOL-24H\source\include\Util.hpp", "C++", 0, 0, 0, 6, 0, 1, 7
"c:\Users\Silve\Develop\CSOL-24H\source\lua\$~cmd.lua", "Lua", 2, 0, 0, 0, 0, 1, 3
"c:\Users\Silve\Develop\CSOL-24H\source\lua\Command.lua", "Lua", 16, 0, 0, 0, 0, 0, 16
"c:\Users\Silve\Develop\CSOL-24H\source\lua\Console.lua", "Lua", 20, 0, 0, 0, 17, 6, 43
"c:\Users\Silve\Develop\CSOL-24H\source\lua\Context.lua", "Lua", 17, 0, 0, 0, 6, 3, 26
"c:\Users\Silve\Develop\CSOL-24H\source\lua\DateTime.lua", "Lua", 62, 0, 0, 0, 15, 4, 81
"c:\Users\Silve\Develop\CSOL-24H\source\lua\Delay.lua", "Lua", 14, 0, 0, 0, 0, 0, 14
"c:\Users\Silve\Develop\CSOL-24H\source\lua\Executor.lua", "Lua", 73, 0, 0, 0, 9, 7, 89
"c:\Users\Silve\Develop\CSOL-24H\source\lua\Global.lua", "Lua", 31, 0, 0, 0, 1, 1, 33
"c:\Users\Silve\Develop\CSOL-24H\source\lua\Interpreter.lua", "Lua", 50, 0, 0, 0, 2, 3, 55
"c:\Users\Silve\Develop\CSOL-24H\source\lua\Keyboard.lua", "Lua", 128, 0, 0, 0, 34, 12, 174
"c:\Users\Silve\Develop\CSOL-24H\source\lua\Mouse.lua", "Lua", 123, 0, 0, 0, 56, 14, 193
"c:\Users\Silve\Develop\CSOL-24H\source\lua\Player.lua", "Lua", 116, 0, 0, 0, 30, 14, 160
"c:\Users\Silve\Develop\CSOL-24H\source\lua\Runtime.lua", "Lua", 109, 0, 0, 0, 34, 10, 153
"c:\Users\Silve\Develop\CSOL-24H\source\lua\Setting.lua", "Lua", 31, 0, 0, 0, 14, 1, 46
"c:\Users\Silve\Develop\CSOL-24H\source\lua\Utility.lua", "Lua", 32, 0, 0, 0, 10, 4, 46
"c:\Users\Silve\Develop\CSOL-24H\source\lua\Weapon.lua", "Lua", 53, 0, 0, 0, 37, 20, 110
"c:\Users\Silve\Develop\CSOL-24H\source\lua\WeaponList.lua", "Lua", 148, 0, 0, 0, 13, 8, 169
"c:\Users\Silve\Develop\CSOL-24H\source\lua\main.lua", "Lua", 9, 0, 0, 0, 3, 0, 12
"Total", "-", 1034, 23, 8, 1293, 367, 172, 2897